21,18,60,18,21,13,21,13,21,13,13,18,18,18,21,21,21,13,21,13,13,18,18,13,13,13,21,21,18,18,18,18,18,13,21,13,14,15,13,13,13,13,21,13,13,13,13,21,13,13,13,21,13,13,13,13,13,13,13,13,13,21,21,21,13,13,21,21,13,21,21,21,21,13,13,13,13,21,21,21
13,18,18,18,21,21,13,13,21,21,13,18,18,18,21,13,13,13,21,21,21,18,18,14,15,21,13,13,18,18,18,18,18,21,21,21,22,23,13,21,13,18,18,18,18,18,18,18,18,18,18,18,18,18,18,18,18,18,18,18,18,18,18,18,18,18,18,18,18,18,18,18,18,18,18,18,18,18,18,18
21,18,18,18,21,21,13,21,21,13,21,18,18,18,21,21,13,13,13,21,21,18,18,22,23,21,13,13,18,18,18,18,18,13,21,21,13,21,13,21,13,18,18,18,18,18,18,18,18,18,18,18,18,18,18,18,18,18,18,18,18,18,18,18,18,18,18,18,18,18,18,18,18,18,18,18,18,18,18,18
13,18,18,18,18,13,18,21,18,13,18,18,18,18,13,18,13,18,21,18,13,18,18,13,18,21,18,13,18,18,18,18,18,13,18,21,18,21,18,13,18,18,18,18,18,18,18,18,18,18,18,18,18,18,18,18,18,18,18,18,18,18,18,18,18,18,18,18,18,18,18,18,18,18,18,18,18,18,18,18
21,18,18,18,18,18,18,18,18,18,18,18,18,18,18,18,18,18,18,18,18,18,18,18,18,18,18,18,18,18,18,18,18,18,18,18,18,18,18,18,18,18,18,18,18,18,18,18,18,18,18,18,18,18,18,18,18,18,18,18,18,51,52,18,18,18,18,18,18,18,18,18,18,18,18,18,18,18,18,18
21,18,18,18,18,18,18,18,18,18,18,18,18,18,18,18,18,18,18,18,18,18,18,18,18,18,18,18,18,18,18,18,18,18,18,18,18,18,18,18,18,18,18,18,18,18,18,18,18,18,18,18,18,18,18,18,18,18,18,18,18,18,18,18,18,18,18,18,51,52,18,18,18,18,18,18,18,18,18,18
13,18,18,18,18,18,18,18,18,18,18,18,18,18,18,18,18,18,18,18,18,18,18,18,18,18,18,18,18,18,18,18,18,18,18,18,18,18,18,18,18,18,18,18,18,18,18,18,18,18,18,18,18,18,18,18,18,18,18,18,18,18,18,18,18,18,18,18,18,18,18,18,18,18,18,18,18,18,18,18
21,18,18,18,18,18,18,18,18,18,18,18,18,18,18,18,18,18,18,18,18,18,18,18,18,18,18,18,18,18,18,18,18,18,18,18,18,18,18,18,18,18,18,18,18,18,18,18,18,18,18,18,66,66,66,66,66,66,66,18,18,18,18,18,18,18,18,18,18,18,18,18,18,18,18,18,18,18,18,18
13,18,18,18,18,18,18,18,18,18,18,18,18,18,18,18,18,18,18,18,18,18,18,18,18,18,18,18,18,18,18,18,18,18,18,18,18,18,18,18,18,18,18,18,18,18,18,18,18,18,18,18,21,21,21,13,13,21,21,18,18,10,18,18,18,18,18,18,18,18,18,18,18,18,18,18,18,18,18,18
21,18,18,18,18,18,18,18,11,18,18,18,18,18,18,18,18,18,18,18,51,52,18,18,18,18,18,11,18,18,18,18,18,18,18,18,18,18,18,18,18,18,18,18,51,52,18,18,18,18,18,18,18,18,18,18,18,18,18,18,18,18,18,18,18,18,18,18,18,18,18,11,18,18,18,18,18,18,18,18
21,18,18,18,18,18,18,18,18,18,18,18,18,18,18,18,18,18,18,18,18,18,18,18,18,18,18,18,18,18,18,18,18,51,52,18,18,18,18,18,18,18,18,18,18,18,18,18,18,18,66,66,66,66,66,66,66,66,66,66,66,18,18,18,18,18,18,18,18,18,18,18,18,18,18,18,18,18,18,18
21,18,18,18,18,18,18,18,18,18,18,18,18,18,18,18,18,18,18,18,18,18,18,18,18,18,18,18,18,18,18,18,18,18,18,18,18,18,18,18,18,18,18,18,18,18,18,18,18,18,13,13,21,13,21,21,21,13,21,21,13,18,18,18,18,18,18,18,18,18,18,18,18,18,18,18,18,18,18,18
21,18,18,18,18,18,18,18,18,18,18,18,18,63,18,18,18,18,18,18,18,18,18,18,18,18,18,18,18,63,18,18,18,18,18,18,18,63,18,18,18,18,18,18,18,18,18,18,18,18,18,18,18,18,18,18,18,18,18,18,18,18,18,18,18,18,18,11,18,18,18,18,18,18,18,18,18,18,18,18
21,18,18,18,18,18,18,18,18,18,18,18,18,18,18,18,18,18,18,18,18,18,18,18,18,18,18,18,18,18,18,18,18,18,18,18,18,18,18,18,18,18,18,11,18,18,18,18,18,18,18,18,18,18,18,18,18,18,18,18,18,18,18,18,18,18,18,18,18,18,18,18,18,18,18,18,18,18,18,18
21,18,18,18,18,18,18,18,18,18,18,18,18,18,18,18,18,18,18,18,18,18,18,18,18,18,18,18,18,18,18,18,18,18,18,18,18,18,18,18,18,18,18,18,18,18,18,18,18,18,18,18,18,18,18,18,18,18,18,18,18,18,18,18,18,18,18,18,18,18,18,18,18,18,18,18,18,18,18,18
21,18,18,18,18,18,18,18,18,18,18,18,18,18,18,18,18,18,18,18,18,18,10,18,18,18,18,18,18,18,18,18,18,18,18,18,18,18,18,18,18,18,18,18,18,18,18,18,18,18,18,18,18,18,18,18,18,18,18,18,18,18,18,18,18,18,18,18,18,18,18,18,18,18,18,18,18,18,18,18
13,18,18,18,18,18,18,18,18,18,18,18,18,18,18,18,18,18,18,18,18,18,18,18,18,18,18,18,18,18,18,18,18,18,18,18,18,18,18,18,18,18,18,18,18,18,18,18,18,18,18,18,18,18,18,18,18,18,18,18,18,18,18,18,18,18,18,18,18,18,18,18,18,18,18,18,18,18,18,18
21,18,18,18,18,18,18,18,18,18,18,18,18,18,18,18,18,18,18,18,18,18,18,18,18,18,18,18,18,18,18,18,18,18,18,18,18,18,18,18,18,18,18,18,18,18,18,18,18,10,18,18,18,18,18,18,18,18,18,18,18,18,18,63,18,18,18,18,18,18,18,63,18,18,18,18,18,18,18,18
21,18,18,18,18,18,18,18,18,18,18,18,18,18,18,18,18,18,18,18,18,18,18,18,18,18,18,18,18,18,18,18,18,18,18,18,18,18,18,18,18,18,18,18,18,18,18,18,18,18,18,18,18,18,18,18,18,18,18,18,18,18,18,18,18,18,18,18,18,18,18,18,18,18,18,18,18,18,18,18
21,18,18,18,18,18,18,18,18,18,18,18,18,18,18,18,18,18,18,18,18,18,18,18,18,18,18,18,18,18,18,18,18,18,18,18,18,18,18,18,18,18,18,18,18,18,18,18,18,18,18,18,18,18,18,18,18,18,18,18,18,18,18,18,18,18,18,18,18,18,18,18,18,18,18,18,18,18,18,18
13,18,18,18,18,53,54,18,18,18,18,18,18,18,18,18,18,18,18,18,18,18,18,18,18,18,18,18,18,18,18,18,18,18,18,18,18,18,18,18,18,18,18,18,18,18,18,18,18,18,18,18,18,18,18,18,18,18,18,18,18,18,18,18,18,18,18,18,18,18,18,18,18,18,18,18,18,18,18,18
21,18,18,18,53,55,55,54,18,18,18,18,18,18,18,18,18,18,18,18,18,18,18,18,18,18,18,18,18,18,18,18,18,18,18,18,18,18,18,18,18,18,18,18,18,18,18,18,18,18,18,18,18,18,18,18,18,18,18,18,18,18,18,18,18,18,18,18,18,18,18,18,18,18,18,18,18,18,18,18
21,18,18,53,55,55,55,55,54,18,18,18,18,18,18,18,18,18,18,18,18,18,18,18,18,18,18,18,18,18,18,18,18,18,18,18,18,18,18,18,18,18,18,18,18,18,18,18,18,18,18,18,18,18,18,18,18,18,18,18,18,18,18,18,18,18,18,18,18,18,18,18,18,18,18,18,18,18,18,18
21,18,53,55,55,55,55,55,55,54,18,18,18,18,18,18,64,17,19,19,61,18,18,18,18,64,61,18,65,18,18,62,18,18,19,17,19,17,17,18,62,18,18,18,18,18,18,18,18,18,18,18,18,18,18,18,18,18,18,18,18,18,18,18,18,18,18,18,18,18,18,18,18,18,18,18,18,16,16,47
21,13,13,13,13,13,21,13,21,21,21,21,19,18,18,19,13,13,13,21,21,18,18,18,16,21,13,13,18,18,18,13,13,21,21,13,13,21,13,13,13,18,18,18,18,18,18,18,18,18,18,18,18,18,18,18,18,18,18,18,18,18,18,18,18,18,18,18,18,18,19,19,18,18,18,18,18,13,13,13
21,6,7,13,14,15,13,13,13,13,13,21,13,18,61,21,21,13,13,13,13,13,18,18,21,13,21,21,18,18,18,13,14,15,13,21,13,21,14,15,21,5,5,4,4,21,13,5,4,4,4,21,21,4,5,4,4,21,21,5,5,5,5,20,20,4,5,5,5,5,21,21,5,5,4,5,5,14,15,13
13,14,15,21,22,23,13,21,13,21,21,21,21,21,13,13,21,13,21,13,13,21,21,21,21,13,13,21,18,18,18,21,22,23,21,13,21,13,22,23,21,12,12,12,12,12,12,12,12,12,12,12,12,12,12,12,12,12,12,12,12,12,12,12,12,12,12,12,12,12,12,12,12,12,12,12,12,22,23,21
21,21,13,13,13,21,13,6,7,21,13,21,21,21,13,21,21,6,7,21,21,21,13,13,13,13,13,21,18,18,18,21,13,21,13,13,6,7,13,13,13,12,12,12,12,12,12,12,12,12,12,12,12,12,12,12,12,12,12,12,12,12,12,12,12,12,12,12,12,12,12,12,12,12,12,12,12,13,13,13
13,21,13,13,21,13,13,14,15,13,13,13,21,13,21,21,21,14,15,13,13,13,21,14,15,21,21,21,18,18,18,21,13,21,13,13,14,15,21,21,21,12,12,12,12,12,12,12,12,12,12,12,12,12,12,12,12,12,12,12,12,12,12,12,12,12,12,12,12,12,12,12,12,12,12,12,12,14,15,13
13,13,21,21,13,21,13,13,13,13,13,13,21,13,13,13,21,13,21,13,13,13,21,22,23,21,21,21,45,45,45,21,21,13,21,21,13,21,13,21,21,12,12,12,12,12,12,12,12,12,12,12,12,12,12,12,12,12,12,12,12,12,12,12,12,12,12,12,12,12,12,12,12,12,12,12,12,22,23,21
